....................
.......W....W.......
***.................
......***..***......
1..................X
****............****
....................
W.W.W..........W.W.W
*****..........*****
....................
W.W.W..........W.W.W
******........******
....................
...W.W........W.W...
...****......****...
....................
*...W..........W...*
...***........***...
....................
....P.........W.....
...***.......***....
....................
Watch out, the ice is slippery!
30