........&...&.............
........&...&.............
........&.X.&.............
.......######.............
..W..............W.W.W.W.W
####..W.W.W.W....#########
.......W.W.WBW............
......++++++++............
....-...........-.........
..........................
W..W............W.W.W.W.W.
####............##########
..........................
.1.........A...W..W..W..L.
#######..*****************
Do not touch the flames, and watch how they move.
30